1111111111111111111111111111111111111111111111111111111111111111
11111111111111111111111111............11111111111111111111111111
11111111111111111111111........M.........11111111111111111111111
1111111111111111111..........................1111111111111111111
1111111111111111111..........................1111111111111111111
1111111111111111........1..............1........1111111111111111
111111111111111........1................1........111111111111111
1111111111111.....1....1................1....1.....1111111111111
111111111111.....1.....1................1.....1.....111111111111
111111111111.....1.....1................1.....1.....111111111111
111111111111.....1....1..................1....1.....111111111111
111111111111.....1............................1.....111111111111
111111111111.............111........111.............111111111111
111111111111.............111........111.............111111111111
111111111111........................................111111111111
111111111111..M............M.......M...........M....111111111111
111111111111........................................111111111111
111111111111.............111........111.............111111111111
111111111111.....1.......111........111.......1.....111111111111
111111111111.....1....1..................1....1.....111111111111
111111111111.....1.....1................1.....1.....111111111111
111111111111.....1.....1................1.....1.....111111111111
111111111111......1....1........P.......1....1......111111111111
1111111111111..........1................1..........1111111111111
111111111111111.........1..............1.........111111111111111
11111111111111111..............................11111111111111111                 
1111111111111111111..........................1111111111111111111
11111111111111111111111.........M........11111111111111111111111
11111111111111111111111111............11111111111111111111111111
1111111111111111111111111111111111111111111111111111111111111111